ρ	r	r
Ρ	R	R
ῥ	rh	rh
Ῥ	Rh	Rh
ῤ	r	r
᾽Ρ	Rh	Rh
α	a	a
ε	e	e
η	ē	i
ι	i	i
ο	o	o
υ	u	y
ω	ō	o
Α	A	A
Ε	E	E
Η	Ē	I
Ι	I	I
Ο	O	O
Υ	U	Y
Ω	Ō	O
ἁ	ha	a
ἑ	he	e
ἡ	hē	i
ἱ	hi	i
ὁ	ho	o
ὑ	hu	y
ὡ	hō	o
Ἁ	Ha	A
Ἑ	He	E
Ἡ	Hē	I
Ἱ	Hi	I
Ὁ	Ho	O
Ὑ	Hu	Y
Ὡ	Hō	O
εἰ	ei	i
ου	ou	ou
αι	ai	e
οι	oi	i
υι	ui	i
αυ	au	av
ευ	eu	ev
ηυ	ēu	iv
